#######
#.    #
#$$ . #
#  @  #
#######
