######
#    #
# $ .#
#  @ #
######
